title=トランプ,height=1,width=1,image
cards/trump_mini_swf/backs.swf	裏向きの札
cards/trump_mini_swf/clubAs.swf	クラブのA
cards/trump_mini_swf/club2s.swf	クラブの2
cards/trump_mini_swf/club3s.swf	クラブの3
cards/trump_mini_swf/club4s.swf	クラブの4
cards/trump_mini_swf/club5s.swf	クラブの5
cards/trump_mini_swf/club6s.swf	クラブの6
cards/trump_mini_swf/club7s.swf	クラブの7
cards/trump_mini_swf/club8s.swf	クラブの8
cards/trump_mini_swf/club9s.swf	クラブの9
cards/trump_mini_swf/club10s.swf	クラブの10
cards/trump_mini_swf/clubJs.swf	クラブのJ
cards/trump_mini_swf/clubQs.swf	クラブのQ
cards/trump_mini_swf/clubKs.swf	クラブのK
cards/trump_mini_swf/diaAs.swf	ダイアのA
cards/trump_mini_swf/dia2s.swf	ダイアの2
cards/trump_mini_swf/dia3s.swf	ダイアの3
cards/trump_mini_swf/dia4s.swf	ダイアの4
cards/trump_mini_swf/dia5s.swf	ダイアの5
cards/trump_mini_swf/dia6s.swf	ダイアの6
cards/trump_mini_swf/dia7s.swf	ダイアの7
cards/trump_mini_swf/dia8s.swf	ダイアの8
cards/trump_mini_swf/dia9s.swf	ダイアの9
cards/trump_mini_swf/dia10s.swf	ダイアの10
cards/trump_mini_swf/diaJs.swf	ダイアのJ
cards/trump_mini_swf/diaQs.swf	ダイアのQ
cards/trump_mini_swf/diaKs.swf	ダイアのK
cards/trump_mini_swf/heartAs.swf	ハートのA
cards/trump_mini_swf/heart2s.swf	ハートの2
cards/trump_mini_swf/heart3s.swf	ハートの3
cards/trump_mini_swf/heart4s.swf	ハートの4
cards/trump_mini_swf/heart5s.swf	ハートの5
cards/trump_mini_swf/heart6s.swf	ハートの6
cards/trump_mini_swf/heart7s.swf	ハートの7
cards/trump_mini_swf/heart8s.swf	ハートの8
cards/trump_mini_swf/heart9s.swf	ハートの9
cards/trump_mini_swf/heart10s.swf	ハートの10
cards/trump_mini_swf/heartJs.swf	ハートのJ
cards/trump_mini_swf/heartQs.swf	ハートのQ
cards/trump_mini_swf/heartKs.swf	ハートのK
cards/trump_mini_swf/spadeAs.swf	スペードのA
cards/trump_mini_swf/spade2s.swf	スペードの2
cards/trump_mini_swf/spade3s.swf	スペードの3
cards/trump_mini_swf/spade4s.swf	スペードの4
cards/trump_mini_swf/spade5s.swf	スペードの5
cards/trump_mini_swf/spade6s.swf	スペードの6
cards/trump_mini_swf/spade7s.swf	スペードの7
cards/trump_mini_swf/spade8s.swf	スペードの8
cards/trump_mini_swf/spade9s.swf	スペードの9
cards/trump_mini_swf/spade10s.swf	スペードの10
cards/trump_mini_swf/spadeJs.swf	スペードのJ
cards/trump_mini_swf/spadeQs.swf	スペードのQ
cards/trump_mini_swf/spadeKs.swf	スペードのK
cards/trump_mini_swf/jokers.swf	ジョーカー
cards/trump_mini_swf/jokers.swf	ジョーカー
cards/trump_mini_swf/jokers.swf	ジョーカー
cards/trump_mini_swf/jokers.swf	ジョーカー
cards/trump_mini_swf/jokers.swf	ジョーカー
cards/trump_mini_swf/jokers.swf	ジョーカー
cards/trump_mini_swf/jokers.swf	ジョーカー
cards/trump_mini_swf/jokers.swf	ジョーカー
cards/trump_mini_swf/jokers.swf	ジョーカー
cards/trump_mini_swf/jokers.swf	ジョーカー
